ANDRé	AE N D R
ASIMOV	AE S IH M AA V
ASIMOV(2)	AE Z IH M AA V
BONJOUR	B AH N ZH UH R
BYE	B AY
CA	K AH
CA(2)	S IY EY
CA(3)	K AA
CARINE	K AA R IY N IY
CHRISTIANE	K R IH S T IY AA N
COMMENT	K AA M EH N T
DAVID	D EY V IH D
EST	EH S T
J'AIME	JH EY M
JE	JH IY
JS	JH EY S
MON	M OW N
MON(2)	M AA N
N'AIME	N EY M
NOM	N AA M
OK	OW K EY
PAS	P AA Z
SHANY	SH EY N IY
SIMON	S AY M AH N
SPIKE	S P AY K
TU	T UW
VA	V AA
VAS	V AE Z
